

NO ./texture/eagle.xpm
SO ./texture/wood.xpm
C 160,82,45
F 0,0,0
WE ./texture/eagle.xpm
EA ./texture/wood.xpm
D1 ./texture/door/1_new.xpm
D2 ./texture/door/3_new.xpm
D3 ./texture/door/4_new.xpm

                      
      11111111111111111111111111
        1000100001100000000000001
        1011010001110010101010001
        100100000D0D0101010101001
111111111011010101110000000000001
100000000001010101110111111101111
1111011111D111D111100000010001
11110111110111011101010010001    
11000000110101D11100000010001    
10000000000000001100000010001
10000000000000001101010010001
1100000111010101111101111000111  
11110101 11111N1 101111010001
11111111 111 111 11111111111

