

NO ../Cub3d/textures/bluestone.xpm
SO ../Cub3d/textures/floor_1.xpm
C 160,82,45
F 0,0,0
WE ../Cub3d/textures/wall_4.xpm
EA ../Cub3d/textures/purplestone.xpm
D ./texture/door/1_new.xpm


11111111111111111111
1000S000D0D000D00001
1001D1001D10001001D1
1001D10001D1001D1001
1001D100000010000001
11111111111111111111



