

NO ./texture/white-brick.xpm
SO          ./texture/eagle.xpm
F 160,82,45
C 119,181,254
WE ./texture/natural-texture.xpm
EA ./texture/wood.xpm


        1111111111111111111111111
        1000101001100000000000001
        101101W001110010110010001
        1001001000000101001101001
111111111011000001110000000000001
100000000011000001110111111101111
11110111111111011100000010001
11110111111111011101010010001    
11000000110101011100000010001    
10001001000000001100000010001
10000110000000001101010010001
1100000111010101111101111000111  
11110101 1111101 101111010001
11111111 111 111 111111111111



