

NO ../Cub3d/textures/bluestone.xpm
SO ../Cub3d/textures/floor_1.xpm
F 160,82,45
C 119,181,254
WE ../Cub3d/textures/wall_4.xpm
EA ../Cub3d/textures/purplestone.xpm
D ./texture/door/1_new.xpm


        1111111111111111111111111
        10001111D1100000000000001
        101101E001111111110010001
        100101100DDDD00D000000001
11111111101100000D11111100000001
100000000011000001110111111101111
11110111111111011100000010001
11110111111111011101010010001    
11000000110101011100000010001    
10001001000000001100000010001
10000110000000001101010010001
1100000111010101111101111000111  
11110101 1111101 101111010001
11111111 111 111 111111111111



