NO ./texture/test.xpm
SO          ./texture/test map.xpm
F 220,100,0
C 225,30,0
WE ./texture/test.xpm
EA ./texture/test.xpm


        1111111111111111111111111
        10000000011N0000000000001
        1011000001110000000000001
        1001000000000000000000001
111111111011000001110000000000001
100000000011000001110111111101111
11110111111111011100000010001
11110111111111011101010010001
11000000110101011100000010001
10000000000000001100000010001
10000000000000001101010010001
1100000111010101111101111000111
11110111 1111101 101111010001
11111111 111 111 111111111111





